12 12
S 1 1 1 1 2 1 1 1 1 1 1
1 # 1 1 2 1 # 1 2 1 1 1
1 1 # 1 1 1 1 1 1 2 1 1
1 2 1 # 1 2 1 1 1 # 1 1
1 1 1 1 # 1 1 1 2 1 1 1
1 # 1 2 1 1 # 1 1 1 2 1
1 1 1 1 1 # 1 1 1 1 1 1
1 2 # 1 1 1 1 2 # 1 1 1
1 1 1 # 2 1 1 1 1 1 1 1
1 1 2 1 1 # 1 1 2 1 1 1
1 # 1 1 1 1 # 1 1 1 2 1
1 1 1 1 1 1 1 1 1 1 1 G
